live up to|어울리는 생활을 하다; (기대 등에) 부응하다
fluent|유창한, 유창하게 말하는
punctual|시간을 잘 지키는, 시간을 엄수하는
come up with|~이 생각나다, 창안하다
bring up|~을 기르다, 양육하다; 제기하다
come up to|~에 도달하다
pick up|~을 집어 올리다; 도중에 태우다
use up|~을 다 써버리다, 소모하다
meantime|그동안; 그동안[사이]에
randomly|임의로
catch up with|따라잡다; 만회하다
rather|약간; 오히려, 차라리
gigantic|거대한
cover up|숨기다, 은폐하다
turn up|(모습이) 나타나다; 도착하다
look up to|~을 존경하다
end up|결국 ~하게 되다
set up|시작하다, 창설하다; ~을 건립하다, 세우다
keep up with|뒤떨어지지 않다
prompt|신속한, 재빠른; 자극하다
approximate|가까운; 대략의; (~에) 가깝다
rare|드문, 진기한
vast|거대한, 막대한
hang up|~을 걸다, 매달다; 전화를 끊다
overall|전부의, 총체적인; 전반적으로
throw up|토하다
barely|간신히; 거의 ~않다
stay up|자지 않고 일어나 있다
substantial|상당한
dare|감히 ~하다, (위험을) 무릅쓰다
stand up for|~을 옹호하다, 지지하다
extreme|극도의; 과격한; 극단
simultaneous|동시에 일어나는, 동시의
rapid|빠른, 신속한
eternal|영원한
rough|대강의; 거친; 힘든
warm up|준비운동을 하다
outdated|구식의, 시대에 뒤진
make up for|만회하다, 보충하다
pull up|서다, 멈추다
put up with|참다, 견디다
severe|엄한, 엄격한; 맹렬한
sum up|요약하다
take up|~을 시작하다
indeed|실로, 참으로; 정말
seldom|드물게, 좀처럼 ~않는
scarce|부족한, 드문
brief|잠깐의; 간결한; 요약서
blow up|폭발하다, 터지다
ultimate|최후의, 최종의; 궁극의
durable|내구력이 있는, 튼튼한; 영속성 있는
maximum|최대치; 최대의, 최고의
hold up|지연시키다; 정지하다, 서다
swift|신속한, 재빠른
be up to|~에게 달렸다
pile up|~을 쌓다; 축적하다
essential|본질적인; 가장 중요한; 기본적인 요소
back up|~을 지원하다
break up|갈라서다; 박살을 내다
look up|~을 찾다, 조사하다
