depress|낙담시키다, 우울하게 하다; 불경기로 만들다
settle|해결하다, 끝내다; 정착하다
consequence|결과, 영향; 중요성
revive|소생[회복]시키다; 되살아나다
supervise|감독하다, 관리하다
impress|감동시키다; (도장 등을) 찍다
tremble|떨다, 떨리다; 흔들리다
terrify|겁나게 하다, 무섭게 하다
voyage|항해(하다), 여행(하다)
scientific|과학적인, 과학의
portable|휴대용의, 가지고 다닐 수 있는
deprive|빼앗다, 박탈하다
seemingly|겉보기에는, 얼핏 보기에
probe|조사(하다), 검사하다
reside|살다, 거주하다
sensation|감각, 지각력; 기분; 엄청난 관심
compound|혼합[합성]물; 합성의; 혼합[합성]하다
implement|도구; 실행[이행]하다
primitive|원시의, 원시적인
component|구성 요소, 성분; 구성하는
opponent|상대; 반대자
resemble|~와 닮다, 비슷하다
previous|이전의, 앞의, 사전의
insert|삽입하다, 넣다; 덧붙이다
impose|부과하다; 강요하다
require|필요로 하다; 요구하다
prior|이전의, 먼저의; (~에) 우선하는
convey|전하다, 전달하다; 나르다
desert|사막; 버리다, 떠나다
dispute|논쟁(하다); 반박하다
vision|시력; 시야; 통찰력
reputation|평판, 명성
prove|증명하다, 입증하다; (~으로) 판명되다
obsess|사로잡다; ~생각만 하게 하다
exquisite|정교한, 매우 아름다운
rational|이성적인; 합리적인, 분별 있는
private|사적인, 개인적인; 비밀의
conquer|정복하다; 이기다; 극복하다
sense|감각; 느낌; 분별력
subsequent|다음의, 그 이후의
sequence|연속, 잇달아 일어남; 순서
scent|냄새(를 풍기다), 향기
convict|유죄를 입증[선고]하다; 죄수
consent|동의(하다), 승낙(하다)
resent|분개하다, 불쾌하게 여기다
metropolis|주요 도시, 대도시
via|~을 경유해서, ~을 통해서
probable|있음 직한, 그럴듯한
suppose|추측하다; 가정하다, 상상하다
vital|매우 중요한; 활기찬; 생명 유지에 필요한
simulation|모의실험, 흉내, 시뮬레이션
tremendous|엄청난, 막대한; 대단한
territory|영토, 지역; 영역
oppress|억압하다, 탄압하다
session|학년, 학기; 진행 중인 시기
assemble|모으다, 모이다; 조립하다
inquire|묻다, 알아보다; 조사하다
voluntary|자발적인; 자원봉사의
souvenir|기념품, 기념 선물
intervene|개입하다; 끼어들다; 사이에 일어나다
